####################
#..................#
#.####.#----#.####.#
#.#  #.#    #.#  #.#
#.####.######.####.#
#..................#
#.####.##..##.####.#
#.#  #........#  #.#
#.####.##..##.####.#
#..................#
#.####.######.####.#
#.#  #.#    #.#  #.#
#.####.######.####.#
#..................#
#.####.##..##.####.#
#.#  #.###....#  #.#
#.#  #.....##.#  #.#
#.####..##.#..####.#
#..................#
###############     